20.ox
oo.....o....o.....o.
o.oo.o..o........o.o
..............o..ooo
.o.ooo.oo.....o...o.
......oooo.........o
...o.oo.....o...o...
...o...o...o.o.o....
...oo..oo...o.......
o..o..ooo.......o...
o.o...o........o....
oo.......o.o......o.
........o..o.o..o.o.
...oo..o.o.o.....o..
o.o......o....o.oo..
o......oo....o.o..o.
...o.....o....o...o.
.o.....o....o..o....
.........o....o.....
.ooo..o.............
....oo...ooo....o..o
