20.ox
o..ooo........o.....
oo...o.o.........o..
.....o.oo...o.oo..o.
o......o...........o
....o.......oooooo..
.o......o....o.o..o.
o.........o.........
......o........o....
...o..o........o.o..
........o...o...o...
.o.o...............o
....o...............
.............oo.....
.....o.ooo.o....o.o.
..............o.....
..o.............o.oo
...o...o............
o..........o.......o
..o..o........oo.o..
.....o...o.o.....ooo
